id,date,id_day,negative,positive,sentiment
1,2022-02-14,1,3,23,20
2,2022-02-19,1,9,41,32
3,2022-02-24,1,2,9,7
4,2022-02-25,1,4,14,10
5,2022-02-25,2,7,8,1
6,2022-02-25,3,7,11,4
7,2022-02-26,1,10,7,-3
8,2022-02-26,2,6,11,5
9,2022-02-27,1,2,1,-1
10,2022-02-27,2,10,9,-1
11,2022-02-27,3,1,2,1
12,2022-02-28,1,10,11,1
13,2022-02-28,2,5,8,3
14,2022-03-01,1,5,6,1
15,2022-03-02,1,4,5,1
16,2022-03-03,1,16,6,-10
17,2022-03-03,2,15,10,-5
18,2022-03-04,1,8,7,-1
19,2022-03-04,2,16,14,-2
20,2022-03-05,1,6,14,8
21,2022-03-05,2,14,12,-2
22,2022-03-06,1,7,27,20
23,2022-03-06,2,2,2,0
24,2022-03-07,1,3,18,15
25,2022-03-07,2,4,15,11
26,2022-03-08,1,10,16,6
27,2022-03-08,2,7,12,5
28,2022-03-08,3,5,9,4
29,2022-03-09,1,4,11,7
30,2022-03-09,2,5,20,15
31,2022-03-10,1,3,9,6
32,2022-03-11,1,6,10,4
33,2022-03-11,2,2,10,8
34,2022-03-11,3,4,18,14
35,2022-03-12,1,14,31,17
36,2022-03-12,2,10,22,12
37,2022-03-12,3,13,21,8
38,2022-03-13,1,13,25,12
39,2022-03-14,1,6,18,12
40,2022-03-14,2,8,27,19
41,2022-03-15,1,8,8,0
42,2022-03-15,2,11,16,5
43,2022-03-15,3,8,20,12
44,2022-03-16,1,12,24,12
45,2022-03-16,2,16,19,3
46,2022-03-16,3,8,23,15
47,2022-03-17,1,12,15,3
48,2022-03-17,2,7,15,8
49,2022-03-18,1,8,13,5
50,2022-03-18,2,10,16,6
51,2022-03-19,1,15,22,7
52,2022-03-19,2,5,23,18
53,2022-03-20,1,6,31,25
54,2022-03-20,2,6,5,-1
55,2022-03-21,1,2,21,19
56,2022-03-21,2,7,30,23
57,2022-03-22,1,0,4,4
58,2022-03-22,2,9,14,5
59,2022-03-22,3,27,19,-8
60,2022-03-23,1,2,13,11
61,2022-03-23,2,5,18,13
62,2022-03-23,3,10,12,2
63,2022-03-24,1,15,52,37
64,2022-03-24,2,6,15,9
65,2022-03-24,3,7,24,17
66,2022-03-24,4,2,11,9
67,2022-03-25,1,3,9,6
68,2022-03-25,2,0,14,14
69,2022-03-25,3,12,36,24
70,2022-03-25,4,28,20,-8
71,2022-03-26,1,18,27,9
72,2022-03-28,1,3,17,14
73,2022-03-28,2,7,15,8
74,2022-03-29,1,11,9,-2
75,2022-03-29,2,4,16,12
76,2022-03-30,1,9,16,7
77,2022-03-30,2,1,17,16
78,2022-03-31,1,8,25,17
79,2022-03-31,2,9,18,9
80,2022-03-31,3,9,24,15
81,2022-04-01,1,1,20,19
82,2022-04-02,1,4,12,8
83,2022-04-03,1,5,40,35
84,2022-04-03,2,18,16,-2
85,2022-04-04,1,18,28,10
86,2022-04-05,1,7,4,-3
87,2022-04-05,2,3,13,10
88,2022-04-05,3,6,7,1
89,2022-04-06,1,2,13,11
90,2022-04-06,2,10,14,4
91,2022-04-07,1,11,11,0
92,2022-04-07,2,13,21,8
93,2022-04-07,3,14,13,-1
94,2022-04-07,4,7,32,25
95,2022-04-08,1,8,16,8
96,2022-04-08,2,5,23,18
97,2022-04-09,1,4,29,25
98,2022-04-10,1,10,16,6
99,2022-04-11,1,4,4,0
100,2022-04-12,1,8,14,6
101,2022-04-13,1,8,13,5
102,2022-04-13,2,13,14,1
103,2022-04-13,3,6,11,5
104,2022-04-14,1,7,21,14
105,2022-04-15,1,11,19,8
106,2022-04-16,1,8,11,3
107,2022-04-17,1,5,28,23
108,2022-04-18,1,4,22,18
109,2022-04-19,1,10,25,15
110,2022-04-20,1,1,18,17
111,2022-04-21,1,28,18,-10
112,2022-04-22,1,9,16,7
113,2022-04-22,2,4,17,13
114,2022-04-22,3,16,16,0
115,2022-04-24,1,4,14,10
116,2022-04-24,2,11,31,20
117,2022-04-25,1,8,26,18
118,2022-04-25,2,15,33,18
119,2022-04-26,1,5,13,8
120,2022-04-27,1,2,18,16
121,2022-04-28,1,11,15,4
122,2022-04-29,1,5,13,8
123,2022-04-30,1,2,16,14
124,2022-05-01,1,3,16,13
125,2022-05-02,1,11,18,7
126,2022-05-03,1,4,23,19
127,2022-05-03,2,5,13,8
128,2022-05-03,3,4,15,11
129,2022-05-04,1,2,9,7
130,2022-05-05,1,2,10,8
131,2022-05-05,2,6,14,8
132,2022-05-05,3,2,30,28
133,2022-05-06,1,3,7,4
134,2022-05-06,2,3,10,7
135,2022-05-06,3,3,23,20
136,2022-05-07,1,4,11,7
137,2022-05-08,1,8,7,-1
138,2022-05-08,2,6,24,18
139,2022-05-08,3,3,33,30
140,2022-05-09,1,6,15,9
141,2022-05-09,2,0,15,15
142,2022-05-10,1,6,18,12
143,2022-05-10,2,6,21,15
144,2022-05-11,1,7,3,-4
145,2022-05-11,2,1,15,14
146,2022-05-12,1,6,23,17
147,2022-05-12,2,0,17,17
148,2022-05-13,1,2,12,10
149,2022-05-14,1,2,16,14
150,2022-05-15,1,3,14,11
151,2022-05-16,1,1,4,3
152,2022-05-17,1,2,15,13
153,2022-05-17,2,2,3,1
154,2022-05-18,1,2,11,9
155,2022-05-18,2,6,6,0
156,2022-05-18,3,0,19,19
157,2022-05-19,1,2,14,12
158,2022-05-19,2,8,22,14
159,2022-05-20,1,4,13,9
160,2022-05-21,1,7,16,9
161,2022-05-22,1,7,38,31
162,2022-05-22,2,1,22,21
163,2022-05-23,1,3,19,16
164,2022-05-23,2,2,14,12
165,2022-05-24,1,11,26,15
166,2022-05-25,1,6,17,11
167,2022-05-26,1,8,17,9
168,2022-05-26,2,12,17,5
169,2022-05-27,1,6,15,9
170,2022-05-27,2,10,27,17
171,2022-05-27,3,2,8,6
172,2022-05-28,1,6,5,-1
173,2022-05-29,1,4,8,4
174,2022-05-30,1,6,19,13
175,2022-05-30,2,6,6,0
176,2022-05-31,1,3,15,12
177,2022-06-02,1,8,5,-3
178,2022-06-02,2,8,19,11
179,2022-06-02,3,13,14,1
180,2022-06-02,4,3,15,12
181,2022-06-03,1,4,30,26
182,2022-06-04,1,6,13,7
183,2022-06-04,2,0,3,3
184,2022-06-04,3,6,10,4
185,2022-06-05,1,1,5,4
186,2022-06-06,1,0,3,3
187,2022-06-06,2,3,27,24
188,2022-06-07,1,6,10,4
189,2022-06-08,1,6,15,9
190,2022-06-08,2,0,8,8
191,2022-06-09,1,2,12,10
192,2022-06-09,2,7,4,-3
193,2022-06-09,3,4,7,3
194,2022-06-10,1,4,7,3
195,2022-06-10,2,13,11,-2
196,2022-06-11,1,2,9,7
197,2022-06-11,2,1,17,16
198,2022-06-11,3,5,8,3
199,2022-06-12,1,3,13,10
200,2022-06-12,2,1,13,12
201,2022-06-13,1,7,9,2
202,2022-06-13,2,4,16,12
203,2022-06-14,1,0,5,5
204,2022-06-15,1,12,17,5
205,2022-06-15,2,3,16,13
206,2022-06-16,1,1,15,14
207,2022-06-17,1,7,8,1
208,2022-06-17,2,4,33,29
209,2022-06-19,1,1,7,6
210,2022-06-19,2,3,22,19
211,2022-06-20,1,1,14,13
212,2022-06-20,2,8,10,2
213,2022-06-20,3,7,11,4
214,2022-06-21,1,2,13,11
215,2022-06-21,2,2,7,5
216,2022-06-21,3,0,23,23
217,2022-06-22,1,7,8,1
218,2022-06-22,2,1,16,15
219,2022-06-23,1,2,19,17
220,2022-06-23,2,4,14,10
221,2022-06-23,3,0,27,27
222,2022-06-24,1,12,35,23
223,2022-06-24,2,2,6,4
224,2022-06-24,3,5,3,-2
225,2022-06-25,1,1,4,3
226,2022-06-25,2,3,12,9
227,2022-06-26,1,2,6,4
228,2022-06-27,1,2,6,4
229,2022-06-28,1,10,25,15
230,2022-06-29,1,8,4,-4
231,2022-06-29,2,4,8,4
232,2022-06-29,3,11,22,11
233,2022-06-29,4,0,18,18
234,2022-06-30,1,1,19,18
235,2022-07-01,1,2,5,3
236,2022-07-01,2,4,28,24
237,2022-07-01,3,3,12,9
238,2022-07-02,1,3,16,13
239,2022-07-03,1,2,15,13
240,2022-07-04,1,5,14,9
241,2022-07-04,2,7,25,18
242,2022-07-04,3,3,15,12
243,2022-07-05,1,3,9,6
244,2022-07-05,2,3,6,3
245,2022-07-06,1,5,10,5
246,2022-07-07,1,4,15,11
247,2022-07-08,1,8,20,12
248,2022-07-09,1,0,12,12
249,2022-07-09,2,2,10,8
250,2022-07-10,1,2,8,6
251,2022-07-11,1,3,10,7
252,2022-07-12,1,3,24,21
253,2022-07-13,1,8,5,-3
254,2022-07-13,2,4,14,10
255,2022-07-14,1,18,12,-6
256,2022-07-14,2,4,7,3
257,2022-07-15,1,2,5,3
258,2022-07-16,1,8,13,5
259,2022-07-17,1,7,8,1
260,2022-07-18,1,8,9,1
261,2022-07-19,1,5,18,13
262,2022-07-20,1,6,17,11
263,2022-07-21,1,17,13,-4
264,2022-07-22,1,3,13,10
265,2022-07-23,1,2,11,9
266,2022-07-23,2,2,12,10
267,2022-07-24,1,5,17,12
268,2022-07-25,1,0,11,11
269,2022-07-26,1,2,21,19
270,2022-07-26,2,2,12,10
271,2022-07-27,1,2,15,13
272,2022-07-28,1,2,14,12
273,2022-07-28,2,6,44,38
274,2022-07-28,3,3,22,19
275,2022-07-29,1,11,9,-2
276,2022-07-30,1,2,6,4
277,2022-07-31,1,4,16,12
278,2022-08-01,1,4,15,11
279,2022-08-02,1,3,14,11
280,2022-08-03,1,2,6,4
281,2022-08-03,2,4,19,15
282,2022-08-04,1,6,4,-2
283,2022-08-05,1,2,8,6
284,2022-08-06,1,6,11,5
285,2022-08-07,1,4,10,6
286,2022-08-08,1,8,11,3
287,2022-08-09,1,1,19,18
288,2022-08-10,1,4,11,7
289,2022-08-11,1,5,11,6
290,2022-08-11,2,1,12,11
291,2022-08-12,1,2,17,15
292,2022-08-13,1,3,10,7
293,2022-08-14,1,2,13,11
294,2022-08-15,1,5,7,2
295,2022-08-16,1,11,20,9
296,2022-08-17,1,15,3,-12
297,2022-08-17,2,2,21,19
298,2022-08-18,1,3,12,9
299,2022-08-19,1,4,12,8
300,2022-08-20,1,5,25,20
301,2022-08-22,1,6,8,2
302,2022-08-22,2,2,15,13
303,2022-08-23,1,20,23,3
304,2022-08-23,2,3,32,29
305,2022-08-24,1,17,27,10
306,2022-08-24,2,14,16,2
307,2022-08-24,3,2,10,8
308,2022-08-25,1,11,9,-2
309,2022-08-26,1,5,16,11
310,2022-08-27,1,5,34,29
311,2022-08-28,1,2,12,10
312,2022-08-29,1,7,7,0
313,2022-08-29,2,15,20,5
314,2022-08-29,3,13,17,4
315,2022-08-29,4,1,8,7
316,2022-08-30,1,3,6,3
317,2022-08-31,1,14,16,2
318,2022-08-31,2,0,7,7
319,2022-09-01,1,5,4,-1
320,2022-09-01,2,3,20,17
321,2022-09-01,3,0,4,4
322,2022-09-01,4,6,17,11
323,2022-09-02,1,7,21,14
324,2022-09-02,2,0,19,19
325,2022-09-03,1,6,6,0
326,2022-09-04,1,6,13,7
327,2022-09-05,1,8,22,14
328,2022-09-06,1,9,25,16
329,2022-09-06,2,4,24,20
330,2022-09-07,1,6,26,20
331,2022-09-08,1,7,18,11
332,2022-09-09,1,3,7,4
333,2022-09-10,1,2,21,19
334,2022-09-10,2,10,25,15
335,2022-09-11,1,13,26,13
336,2022-09-12,1,8,7,-1
337,2022-09-13,1,2,14,12
338,2022-09-15,1,9,9,0
339,2022-09-15,2,5,20,15
340,2022-09-16,1,3,11,8
341,2022-09-17,1,6,13,7
342,2022-09-18,1,0,10,10
343,2022-09-19,1,4,20,16
344,2022-09-21,1,5,22,17
345,2022-09-21,2,3,10,7
346,2022-09-22,1,18,17,-1
347,2022-09-22,2,6,24,18
348,2022-09-23,1,8,17,9
349,2022-09-23,2,4,13,9
350,2022-09-23,3,8,31,23
351,2022-09-24,1,6,12,6
352,2022-09-25,1,8,17,9
353,2022-09-26,1,1,15,14
354,2022-09-27,1,6,6,0
355,2022-09-27,2,3,15,12
356,2022-09-28,1,4,13,9
357,2022-09-28,2,3,10,7
358,2022-09-28,3,0,9,9
359,2022-09-29,1,12,3,-9
360,2022-09-29,2,3,8,5
361,2022-09-30,1,15,16,1
362,2022-09-30,2,7,17,10
363,2022-10-01,1,4,13,9
364,2022-10-02,1,2,25,23
365,2022-10-03,1,9,15,6
366,2022-10-04,1,2,15,13
367,2022-10-05,1,18,12,-6
368,2022-10-05,2,3,19,16
369,2022-10-06,1,12,15,3
370,2022-10-06,2,10,12,2
371,2022-10-06,3,12,21,9
372,2022-10-06,4,8,15,7
373,2022-10-07,1,3,6,3
374,2022-10-07,2,1,29,28
375,2022-10-08,1,2,16,14
376,2022-10-08,2,2,20,18
377,2022-10-09,1,4,12,8
378,2022-10-10,1,4,3,-1
379,2022-10-10,2,3,14,11
380,2022-10-11,1,10,18,8
381,2022-10-11,2,6,16,10
382,2022-10-11,3,8,13,5
383,2022-10-12,1,3,14,11
384,2022-10-12,2,9,25,16
385,2022-10-13,1,7,28,21
386,2022-10-13,2,2,19,17
387,2022-10-14,1,18,44,26
388,2022-10-14,2,5,14,9
389,2022-10-15,1,4,9,5
390,2022-10-16,1,3,11,8
391,2022-10-17,1,1,14,13
392,2022-10-18,1,4,15,11
393,2022-10-19,1,2,17,15
394,2022-10-20,1,15,17,2
395,2022-10-20,2,11,17,6
396,2022-10-21,1,4,4,0
397,2022-10-21,2,4,14,10
398,2022-10-22,1,5,19,14
399,2022-10-23,1,5,10,5
400,2022-10-24,1,10,13,3
401,2022-10-24,2,9,22,13
402,2022-10-25,1,10,38,28
403,2022-10-25,2,5,19,14
404,2022-10-25,3,1,19,18
405,2022-10-26,1,6,10,4
406,2022-10-28,1,12,13,1
407,2022-10-28,2,1,15,14
408,2022-10-29,1,19,31,12
409,2022-10-29,2,1,7,6
410,2022-10-30,1,1,12,11
411,2022-10-31,1,11,20,9
412,2022-10-31,2,10,15,5
413,2022-11-01,1,5,10,5
414,2022-11-02,1,5,24,19
415,2022-11-03,1,11,12,1
416,2022-11-04,1,1,17,16
417,2022-11-05,1,3,11,8
418,2022-11-06,1,1,6,5
419,2022-11-07,1,0,16,16
420,2022-11-08,1,3,18,15
421,2022-11-08,2,1,0,-1
422,2022-11-08,3,0,16,16
423,2022-11-09,1,5,12,7
424,2022-11-10,1,6,15,9
425,2022-11-11,1,1,8,7
426,2022-11-11,2,9,14,5
427,2022-11-12,1,1,20,19
428,2022-11-13,1,1,7,6
429,2022-11-14,1,2,24,22
430,2022-11-15,1,16,17,1
431,2022-11-15,2,6,5,-1
432,2022-11-16,1,3,10,7
433,2022-11-16,2,3,9,6
434,2022-11-17,1,5,24,19
435,2022-11-17,2,7,18,11
436,2022-11-18,1,0,5,5
437,2022-11-18,2,1,17,16
438,2022-11-19,1,1,8,7
439,2022-11-19,2,0,10,10
440,2022-11-20,1,3,13,10
441,2022-11-20,2,0,26,26
442,2022-11-21,1,5,32,27
443,2022-11-21,2,8,28,20
444,2022-11-21,3,7,38,31
445,2022-11-22,1,5,15,10
446,2022-11-22,2,2,12,10
447,2022-11-24,1,4,10,6
448,2022-11-24,2,0,4,4
449,2022-11-24,3,4,13,9
450,2022-11-24,4,4,15,11
451,2022-11-25,1,11,20,9
452,2022-11-25,2,1,11,10
453,2022-11-26,1,12,9,-3
454,2022-11-26,2,3,14,11
455,2022-11-27,1,0,12,12
456,2022-11-28,1,12,17,5
457,2022-11-29,1,4,16,12
458,2022-11-29,2,6,8,2
459,2022-11-30,1,2,17,15
460,2022-12-01,1,8,29,21
461,2022-12-02,1,10,15,5
462,2022-12-03,1,0,24,24
463,2022-12-04,1,0,21,21
464,2022-12-05,1,2,16,14
465,2022-12-05,2,2,14,12
466,2022-12-06,1,3,27,24
467,2022-12-07,1,3,6,3
468,2022-12-07,2,4,11,7
469,2022-12-07,3,9,11,2
470,2022-12-08,1,1,12,11
471,2022-12-08,2,1,9,8
472,2022-12-09,1,3,14,11
473,2022-12-09,2,8,18,10
474,2022-12-09,3,13,22,9
475,2022-12-09,4,5,19,14
476,2022-12-10,1,1,15,14
477,2022-12-11,1,1,8,7
478,2022-12-12,1,10,33,23
479,2022-12-12,2,2,12,10
480,2022-12-13,1,7,17,10
481,2022-12-13,2,1,26,25
482,2022-12-13,3,0,19,19
483,2022-12-13,4,8,21,13
484,2022-12-14,1,19,21,2
485,2022-12-14,2,2,29,27
486,2022-12-15,1,16,28,12
487,2022-12-15,2,0,11,11
488,2022-12-16,1,0,6,6
489,2022-12-17,1,1,15,14
490,2022-12-18,1,4,15,11
491,2022-12-19,1,7,25,18
492,2022-12-19,2,4,18,14
493,2022-12-20,1,6,15,9
494,2022-12-22,1,15,37,22
495,2022-12-22,2,2,15,13
496,2022-12-23,1,4,48,44
497,2022-12-23,2,3,20,17
498,2022-12-24,1,3,5,2
499,2022-12-25,1,0,18,18
500,2022-12-26,1,1,10,9
501,2022-12-27,1,3,15,12
502,2022-12-28,1,19,106,87
503,2022-12-28,2,0,6,6
504,2022-12-29,1,4,9,5
505,2022-12-30,1,0,13,13
506,2022-12-31,1,4,5,1
507,2022-12-31,2,15,22,7
508,2023-01-01,1,1,12,11
509,2023-01-02,1,2,9,7
510,2023-01-03,1,0,10,10
511,2023-01-04,1,16,24,8
512,2023-01-05,1,6,16,10
513,2023-01-06,1,0,13,13
514,2023-01-06,2,3,12,9
515,2023-01-07,1,4,13,9
516,2023-01-08,1,1,14,13
517,2023-01-09,1,4,14,10
518,2023-01-10,1,7,30,23
519,2023-01-11,1,1,14,13
520,2023-01-12,1,4,16,12
521,2023-01-13,1,3,11,8
522,2023-01-13,2,5,17,12
523,2023-01-14,1,2,4,2
524,2023-01-15,1,3,6,3
525,2023-01-16,1,5,22,17
526,2023-01-17,1,5,10,5
527,2023-01-17,2,4,8,4
528,2023-01-18,1,9,9,0
529,2023-01-18,2,6,10,4
530,2023-01-19,1,10,3,-7
531,2023-01-19,2,2,16,14
532,2023-01-20,1,1,3,2
533,2023-01-20,2,2,21,19
534,2023-01-21,1,5,8,3
535,2023-01-21,2,1,4,3
536,2023-01-22,1,1,26,25
537,2023-01-22,2,3,25,22
538,2023-01-23,1,9,8,-1
539,2023-01-23,2,3,12,9
540,2023-01-24,1,2,17,15
541,2023-01-25,1,5,22,17
542,2023-01-26,1,5,11,6
544,2023-01-27,2,0,11,11
545,2023-01-28,1,4,4,0
546,2023-01-29,1,2,8,6
547,2023-01-30,1,0,18,18
548,2023-01-31,1,1,11,10
549,2023-02-01,1,4,16,12
550,2023-02-02,1,0,10,10
552,2023-02-02,3,3,18,15
553,2023-02-03,1,0,20,20
554,2023-02-04,1,0,8,8
555,2023-02-05,1,0,11,11
556,2023-02-06,1,2,18,16
557,2023-02-07,1,1,10,9
558,2023-02-08,1,6,18,12
559,2023-02-09,1,3,25,22
560,2023-02-09,2,2,20,18
561,2023-02-10,1,1,4,3
562,2023-02-10,2,4,2,-2
563,2023-02-10,3,1,38,37
564,2023-02-11,1,10,12,2
565,2023-02-12,1,1,13,12
566,2023-02-13,1,0,26,26
567,2023-02-14,1,2,16,14
568,2023-02-15,1,1,14,13
569,2023-02-16,1,6,16,10
570,2023-02-16,2,1,15,14
571,2023-02-17,1,2,15,13
572,2023-02-17,2,9,25,16
573,2023-02-17,3,1,12,11
574,2023-02-17,4,2,22,20
575,2023-02-18,1,6,23,17
576,2023-02-19,1,0,10,10
577,2023-02-20,1,5,32,27
578,2023-02-20,2,9,27,18
579,2023-02-21,1,3,14,11
580,2023-02-22,1,5,31,26
581,2023-02-22,2,3,29,26
582,2023-02-24,1,0,6,6
583,2023-02-24,2,8,19,11
584,2023-02-25,1,4,10,6
585,2023-02-25,2,3,15,12
586,2023-02-25,3,1,20,19
587,2023-02-25,4,2,19,17
588,2023-02-26,1,4,28,24
589,2023-02-27,1,2,5,3
590,2023-02-28,1,11,30,19
591,2023-02-28,2,8,22,14
592,2023-03-01,1,10,7,-3
593,2023-03-02,1,1,8,7
594,2023-03-03,1,14,18,4
595,2023-03-03,2,1,16,15
596,2023-03-04,1,1,12,11
597,2023-03-05,1,0,9,9
598,2023-03-06,1,4,30,26
599,2023-03-07,1,6,24,18
600,2023-03-08,1,0,10,10
601,2023-03-08,2,5,27,22
602,2023-03-09,1,2,33,31
603,2023-03-10,1,4,20,16
604,2023-03-10,2,16,13,-3
605,2023-03-11,1,3,6,3
606,2023-03-12,1,6,44,38
607,2023-03-13,1,1,18,17
608,2023-03-14,1,3,21,18
609,2023-03-15,1,5,19,14
610,2023-03-16,1,4,11,7
611,2023-03-17,1,4,7,3
612,2023-03-18,1,9,12,3
613,2023-03-19,1,5,11,6
614,2023-03-20,1,0,4,4
615,2023-03-21,1,8,34,26
616,2023-03-22,1,4,14,10
617,2023-03-23,1,12,31,19
618,2023-03-23,2,3,12,9
619,2023-03-24,1,5,15,10
620,2023-03-25,1,5,11,6
621,2023-03-25,2,10,22,12
622,2023-03-26,1,9,21,12
623,2023-03-27,1,3,14,11
624,2023-03-28,1,4,12,8
625,2023-03-29,1,10,8,-2
626,2023-03-29,2,5,21,16
627,2023-03-30,1,7,33,26
628,2023-03-30,2,0,44,44
629,2023-03-31,1,0,14,14
630,2023-04-01,1,2,8,6
631,2023-04-02,1,2,11,9
632,2023-04-03,1,6,15,9
633,2023-04-04,1,6,22,16
634,2023-04-04,2,2,14,12
635,2023-04-05,1,5,9,4
636,2023-04-05,2,12,46,34
637,2023-04-06,1,1,16,15
638,2023-04-07,1,4,19,15
639,2023-04-08,1,6,12,6
640,2023-04-09,1,0,7,7
641,2023-04-11,1,0,13,13
642,2023-04-12,1,3,5,2
643,2023-04-12,2,5,18,13
644,2023-04-12,3,8,8,0
645,2023-04-13,1,8,23,15
646,2023-04-14,1,8,5,-3
647,2023-04-15,1,4,10,6
648,2023-04-16,1,3,18,15
649,2023-04-17,1,5,6,1
650,2023-04-18,1,0,12,12
651,2023-04-19,1,0,10,10
652,2023-04-20,1,7,45,38
653,2023-04-20,2,3,23,20
654,2023-04-21,1,14,18,4
655,2023-04-21,2,1,19,18
656,2023-04-22,1,1,6,5
657,2023-04-23,1,0,23,23
658,2023-04-24,1,2,8,6
659,2023-04-25,1,2,6,4
660,2023-04-26,1,11,23,12
661,2023-04-26,2,1,19,18
662,2023-04-27,1,11,4,-7
663,2023-04-28,1,8,7,-1
664,2023-04-29,1,2,10,8
665,2023-04-30,1,0,13,13
666,2023-05-01,1,7,24,17
667,2023-05-02,1,0,11,11
668,2023-05-04,1,5,12,7
669,2023-05-04,2,2,8,6
670,2023-05-05,1,2,26,24
671,2023-05-05,2,3,27,24
672,2023-05-06,1,0,23,23
673,2023-05-07,1,3,25,22
674,2023-05-08,1,14,35,21
675,2023-05-08,2,4,19,15
676,2023-05-09,1,7,4,-3
677,2023-05-09,2,4,16,12
678,2023-05-10,1,1,21,20
679,2023-05-11,1,2,28,26
680,2023-05-12,1,2,7,5
681,2023-05-13,1,2,12,10
682,2023-05-14,1,7,69,62
683,2023-05-15,1,2,19,17
684,2023-05-16,1,2,9,7
685,2023-05-16,2,2,1,-1
686,2023-05-17,1,2,10,8
687,2023-05-18,1,0,9,9
688,2023-05-18,2,6,14,8
689,2023-05-19,1,0,18,18
690,2023-05-20,1,1,17,16
691,2023-05-21,1,2,26,24
692,2023-05-21,2,4,3,-1
693,2023-05-21,3,8,21,13
694,2023-05-21,4,2,21,19
695,2023-05-22,1,0,5,5
696,2023-05-23,1,0,18,18
697,2023-05-24,1,8,8,0
698,2023-05-25,1,1,8,7
699,2023-05-25,2,1,13,12
700,2023-05-25,3,7,13,6
701,2023-05-26,1,2,6,4
702,2023-05-27,1,1,8,7
703,2023-05-28,1,2,12,10
704,2023-05-29,1,1,10,9
705,2023-05-29,2,3,6,3
706,2023-05-30,1,5,12,7
707,2023-05-31,1,2,18,16
708,2023-05-31,2,2,7,5
